100,100,100,100,100,100,100,100,100,100,100,100,100,100,100,100,100,100,100,100,100,100,100,100,100,100,100,100,100,100,100,100,100,100
100,0,0,0,0,0,0,100,100,100,100,0,0,0,0,0,0,0,0,0,0,0,0,100,100,100,100,0,0,0,0,0,0,100
100,0,0,0,0,0,0,100,100,100,100,0,0,0,0,0,0,0,0,0,0,0,0,100,100,100,100,0,0,0,0,0,0,100
100,0,0,0,0,0,0,100,100,100,100,0,0,0,0,0,0,0,0,0,0,0,0,100,100,100,100,0,0,0,0,0,0,100
100,0,0,0,0,0,0,100,100,100,100,0,0,0,0,0,0,0,0,0,0,0,0,100,100,100,100,0,0,0,0,0,0,100
100,0,0,0,0,0,0,100,100,100,100,0,0,0,100,100,4,4,100,100,0,0,0,100,100,100,100,0,0,0,0,0,0,100
100,0,0,0,100,100,100,100,100,100,100,0,0,0,100,100,100,100,100,100,0,0,0,100,100,100,100,100,100,100,0,0,0,100
100,0,0,0,100,100,100,100,100,100,100,0,0,0,0,0,100,100,0,0,0,0,0,100,100,100,100,100,100,100,0,0,0,100
100,0,0,0,0,0,0,100,100,100,100,0,0,0,0,0,100,100,0,0,0,0,0,100,100,100,100,0,0,0,0,0,0,100
100,0,0,0,0,0,0,100,100,100,100,100,100,0,0,0,100,100,0,0,0,100,100,100,100,100,100,0,0,0,0,0,0,100
100,100,100,100,0,0,0,100,100,100,100,100,100,0,0,0,100,100,0,0,0,100,100,100,100,100,100,0,0,0,100,100,100,100
100,100,100,100,0,0,0,0,0,0,0,0,0,0,0,0,100,100,0,0,0,0,0,0,0,0,0,0,0,0,100,100,100,100
100,0,0,0,0,0,0,0,0,0,0,0,0,0,0,0,100,100,0,0,0,0,0,0,0,0,0,0,0,0,0,0,0,100
100,0,0,0,0,0,0,0,0,0,0,0,0,0,100,100,100,100,100,100,0,0,0,0,0,0,0,0,0,0,0,0,0,100
100,0,0,0,100,100,100,100,2,2,100,0,0,0,100,100,100,100,100,100,0,0,0,100,3,3,100,100,100,100,0,0,0,100
100,0,0,0,100,100,100,100,100,100,100,0,0,0,0,0,100,100,0,0,0,0,0,100,100,100,100,100,100,100,0,0,0,100
100,0,0,0,0,0,0,100,100,100,100,0,0,0,0,0,100,100,0,0,0,0,0,100,100,100,100,0,0,0,0,0,0,100
100,0,0,0,0,0,0,100,100,100,100,100,100,0,0,0,100,100,0,0,0,100,100,100,100,100,100,0,0,0,0,0,0,100
100,100,100,100,0,0,0,100,100,100,100,100,100,0,0,0,100,100,0,0,0,100,100,100,100,100,100,0,0,0,100,100,100,100
100,100,100,100,0,0,0,100,100,100,100,0,0,0,0,0,100,100,0,0,0,0,0,100,100,100,100,0,0,0,100,100,100,100
100,0,0,0,0,0,0,100,100,100,100,0,0,0,0,0,100,100,0,0,0,0,0,100,100,100,100,0,0,0,0,0,0,100
100,0,0,0,0,0,0,0,0,0,0,0,0,0,100,100,100,100,100,100,0,0,0,0,0,0,0,0,0,0,0,0,0,100
100,0,0,0,100,100,0,0,0,0,0,0,0,0,100,100,100,100,100,100,0,0,0,0,0,0,0,0,100,100,0,0,0,100
100,100,100,100,100,100,100,100,100,100,100,100,100,100,100,100,100,100,100,100,100,100,100,100,100,100,100,100,100,100,100,100,100,100
100,100,100,100,100,100,100,100,100,100,100,100,100,100,100,100,100,100,100,100,100,100,100,100,100,100,100,100,100,100,100,100,100,100
